111111111111111111111111111111111111
10000000000000000000000000000E000001
100000000000000000000000000000000001
10000000000011CC10011111111110000001
1000000000011CC110011110011110000001
100000000011CC1100011100011110000001
10000000011CC11000011000011110000001
1000000011CC110000010000011110000001
100000011CC1100000000000111110000001
10000011CC11000000000001111100000001
1000011CC1100000P0000011111000000001
100011CC1100000000000111110000000001
10011CC11000000000001111100010000001
1001CC110000000000011111000110000001
1001C1111111111100111110000110000001
100111111111111100111100001110000001
100111111111111100111111111110000001
100000000001111100111111111110000001
100000000001111100000000000000000001
100000000001111100000000000000000001
100000000001111100000000000000000001
100000000000000000000000000000000001
111111111111111111111111111111111111
