11111111111111111111
10C00C011000C000C001
11111000C100C0001001
100P0010C111000C0001
1100111000E001001101
11111111111111111111
