11111111111111111111111111111111111111111
1E0000000001000C000000000001000C000000001
11100101001010001000101000101000100010101
1010010010100100C000101010100100C00010101
100000000C0000000000000C0C000P000000000C1
11100101001010001000101000101000100010101
1010010010100100C000101010100100C00010101
100000000C0000000000000C0C0000000000000C1
11111111111111111111111111111111111111111